32
25
4 4 4 4 4 4 4 4 4 4 4 4 4 4 4 4 4 4 4 4 4 4 4 4 4 4 4 4 4 4 4 4 
4 4 4 20 24 37 24 20 24 24 24 24 24 24 24 24 24 24 24 24 24 24 24 24 24 24 24 20 4 4 4 4 
4 4 4 20 38 36 38 20 1 1 1 1 1 1 1 1 1 1 1 1 1 1 1 1 1 1 1 20 4 4 4 4 
4 5 4 20 1 1 1 20 1 1 1 1 1 1 1 1 1 1 1 1 1 1 1 1 1 1 1 20 4 4 4 4 
6 4 4 20 1 1 1 20 1 1 1 1 1 1 1 1 1 1 1 1 1 1 1 1 1 1 1 20 4 4 4 4 
4 4 4 20 1 1 1 20 1 1 1 20 1 1 20 24 24 20 1 1 20 24 24 20 1 1 1 20 6 4 4 4 
4 6 4 20 1 1 1 20 1 1 1 20 1 1 20 1 1 20 1 1 20 1 1 20 1 1 1 20 4 4 4 4 
4 4 4 20 1 1 1 20 1 1 1 20 1 1 20 1 1 20 1 1 20 1 1 20 1 1 1 20 4 4 4 4 
4 4 4 20 1 1 1 20 1 1 1 20 1 1 20 1 1 20 1 1 20 1 1 20 1 1 1 20 4 30 4 4 
4 4 4 20 1 1 1 20 1 1 1 24 24 24 24 1 1 24 24 24 24 1 1 20 1 1 1 20 6 4 4 4 
4 4 4 20 1 1 1 20 1 1 1 1 1 1 1 1 1 1 1 1 1 1 1 20 1 1 1 20 4 4 4 4 
4 4 4 20 1 1 1 20 1 1 1 1 1 1 1 1 1 1 1 1 1 1 1 20 1 1 1 20 4 4 4 4 
4 4 4 20 1 1 1 20 1 1 1 1 1 1 1 1 1 1 1 1 1 1 1 20 1 1 1 20 4 4 4 4 
4 4 4 20 1 1 1 20 1 1 1 1 1 1 1 1 1 1 1 1 1 1 1 20 1 1 1 20 5 4 4 4 
4 4 5 20 1 1 1 20 1 1 1 1 1 1 1 1 1 1 1 1 1 1 1 20 1 1 1 20 5 6 4 4 
4 4 4 20 1 1 1 20 1 1 1 1 1 1 1 1 1 1 1 1 1 1 1 20 1 1 1 20 4 4 4 4 
4 4 4 20 1 1 1 20 1 1 1 1 1 1 1 1 1 1 1 1 20 1 1 20 1 1 1 20 4 4 4 4 
4 6 4 20 1 1 1 20 1 1 1 1 1 1 1 1 1 1 1 1 20 1 1 20 1 1 1 20 4 4 4 4 
4 4 4 20 1 1 1 24 24 24 24 24 24 24 24 24 24 24 24 24 24 1 1 20 1 1 1 20 4 5 4 4 
4 4 4 20 1 1 1 1 1 1 1 1 1 1 1 1 1 1 1 14 1 1 1 20 1 1 1 20 4 4 4 4 
4 4 4 20 1 1 1 1 1 1 1 1 1 1 1 1 1 1 1 14 1 1 1 20 1 1 1 20 6 4 4 4 
4 4 4 20 1 1 1 1 1 1 1 1 1 1 1 1 1 1 1 14 1 1 1 20 1 1 1 20 4 5 4 4 
4 4 5 24 24 24 24 24 24 24 24 24 24 24 24 24 24 24 24 24 24 24 24 24 8 8 8 24 4 4 4 4 
4 4 4 38 38 38 38 38 38 38 38 38 38 38 38 38 38 38 38 38 38 38 38 38 4 4 4 38 4 4 4 4 
39 39 39 39 39 39 39 39 39 39 39 39 39 39 39 39 39 39 39 39 39 39 39 39 39 39 39 39 39 39 39 0 
