32
25
20 20 20 20 20 20 20 20 24 24 20 20 24 24 20 20 24 24 20 20 24 24 20 20 20 20 20 20 20 20 20 20 
20 20 20 20 20 20 20 20 1 1 20 20 1 1 20 20 1 1 20 20 1 1 20 20 20 20 20 20 20 20 20 20 
20 20 20 20 20 20 20 20 1 1 20 20 1 1 20 20 1 1 20 20 1 1 20 20 20 20 20 20 20 20 20 20 
20 20 20 20 20 24 24 24 1 1 24 24 1 1 24 24 1 1 24 24 1 1 24 24 24 24 24 24 24 24 24 20 
20 20 20 20 20 1 1 1 1 1 1 1 1 1 1 1 1 1 1 1 1 1 1 1 1 1 1 1 1 1 1 20 
20 20 20 20 20 1 1 1 1 1 1 1 1 1 1 1 1 1 1 1 1 1 1 1 1 1 1 1 1 1 1 20 
20 20 20 20 20 1 1 1 20 20 1 1 20 20 1 1 20 20 1 1 20 20 1 1 1 1 1 1 20 20 20 20 
20 20 20 20 20 1 1 1 20 20 1 1 20 20 1 1 20 20 1 1 20 20 1 1 1 1 1 1 24 24 24 20 
20 20 24 24 24 1 1 1 20 20 1 1 20 20 1 1 20 20 1 1 20 20 20 20 20 1 1 1 1 1 1 20 
20 20 1 1 1 1 1 1 20 20 20 20 24 24 37 24 24 20 20 20 20 20 24 24 24 1 1 1 1 1 1 20 
20 20 1 1 1 1 1 1 24 24 24 20 38 38 36 38 38 20 20 20 20 20 1 1 1 1 1 1 20 20 20 20 
20 20 20 20 20 1 1 1 1 1 1 20 1 1 1 1 1 20 20 20 20 20 1 1 1 1 1 1 24 24 24 20 
20 20 24 24 24 1 1 1 1 1 1 20 1 1 1 1 1 20 20 20 20 20 20 20 20 1 1 1 1 1 1 20 
20 20 1 1 1 1 1 1 20 20 20 20 1 1 1 1 1 24 24 24 24 20 24 24 24 1 1 1 1 1 1 20 
20 20 1 1 1 1 1 1 24 24 24 20 20 20 20 1 1 38 38 38 38 20 1 1 1 1 1 1 20 20 20 20 
20 20 20 20 20 1 1 1 1 1 1 20 24 24 24 1 1 1 1 1 1 20 1 1 1 1 1 1 24 24 24 20 
20 20 24 24 24 1 1 1 1 1 1 20 38 38 38 1 1 20 20 20 20 20 20 20 20 1 1 1 1 1 1 20 
20 20 1 1 1 1 1 1 20 24 24 20 1 1 1 1 1 24 24 24 24 20 24 24 24 1 1 1 1 1 1 20 
20 20 1 1 1 1 1 1 24 1 1 24 24 24 20 1 1 38 38 38 38 20 1 1 1 1 1 1 20 20 20 20 
20 20 20 20 20 1 1 1 1 1 1 1 1 1 20 1 1 1 1 1 1 20 1 1 1 1 1 1 20 20 20 20 
20 20 20 20 20 1 1 1 1 1 1 1 1 1 24 10 10 20 20 20 20 20 20 20 20 1 1 1 20 20 20 20 
20 20 20 20 20 1 1 1 1 1 1 1 1 1 1 1 1 20 20 20 20 20 20 20 20 1 1 1 20 20 20 20 
20 20 20 20 20 1 1 1 1 1 1 1 1 1 1 1 1 20 20 20 20 20 20 20 20 1 1 1 20 20 20 20 
24 24 24 24 24 24 24 24 24 24 24 24 24 24 24 24 24 24 24 24 24 24 24 24 24 24 24 24 24 24 24 24 
38 38 38 38 38 38 38 38 38 38 38 38 38 38 38 38 38 38 38 38 38 38 38 38 38 38 38 38 38 38 38 38 
